11  17
  4  4  4  4  4  4  4  5  5  5  4  4  4  4  4  4  4
  4  0  0  0  0  0  0  0  0  0  0  0  0  0  0  0  4
  4  0  2  4  4  2  4  4  2  4  4  2  4  4  2  0  4
  4  0  4  0  0  0  0  0  0  0  0  0  0  0  4  0  4
  4  0  4  0  2  4  4  2  4  2  4  4  2  0  4  0  5
  4  0  2  0  4  0  0  0  0  0  0  0  4  0  2  0  5
  4  0  4  0  4  0  2  4  2  4  2  0  4  0  4  0  5
  4  0  4  0  2  0  4  2  0  2  4  0  2  0  4  0  4
  4  0  2  0  4  0  2  0  0  0  2  0  4  0  2  0  4
  4  0  4  0  4  0  4  2  0  2  4  0  4  0  4  0  4
  4  4  4  4  4  4  4  5  5  5  4  4  4  4  4  4  4
  1  1  1  1  1  1  1  1  1  1  1  1  1  1  1  1  1
  1  1  1  1  1  1  1  1  1  1  1  1  1  1  1  1  1
  1  1  1  1  1  1  1  1  1  1  1  1  1  1  1  1  1
  1  1  1  1  1  1  1  1  1  1  1  1  1  1  1  1  1
  1  1  1  1  1  1  1  1  1  1  1  1  1  1  1  1  1
  1  1  1  1  1  1  1  1  1  1  1  1  1  1  1  1  1
  1  1  1  1  1  1  1  1  1  1  1  1  1  1  1  1  1
  1  1  1  1  1  1  1  1  1  1  1  1  1  1  1  1  1
  1  1  1  1  1  1  1  1  1  1  1  1  1  1  1  1  1
  1  1  1  1  1  1  1  1  1  1  1  1  1  1  1  1  1
  1  1  1  1  1  1  1  1  1  1  1  1  1  1  1  1  1
  1  1  1  1  1  1  1 18 18 18  1  1  1  1  1  1  1
  1  0  0  0  0  0  0  0  0  0  0  0  0  0  0  0  1
  1  0  6  5  5  6  5  5  6  5  5  6  5  5  6  0  1
  1  0  5  0  0  0  0  0  0  0  0  0  0  0  5  0  1
  1  0  5  0  6  5  5  6  5  6  5  5  6  0  5  0 33
  1  0  6  0  5  0  0  0  0  0  0  0  5  0  6  0 33
  1  0  5  0  5  0  6  5  6  5  6  0  5  0  5  0 33
  1  0  5  0  6  0  5  6  0  6  5  0  6  0  5  0  1
  1  0  6  0  5  0  6  0  0  0  6  0  5  0  6  0  1
  1  0  5  0  5  0  5  6  0  6  5  0  5  0  5  0  1
  1  1  1  1  1  1  1 12 12 12  1  1  1  1  1  1  1
3
3 330 110
5 10 110
9 10 110
18
30  190  250  10  10  5  5  2  4
30  170  250  10  10  5  5  2  4
30  150  250  10  10  5  5  2  4
70  190  200  10  5  5  5  2  4
70  170  200  10  5  5  5  2  4
70  150  200  10  5  5  5  2  4
110  190  200  10  5  5  0  2  4
110  170  200  10  5  5  0  2  4
110  150  200  10  5  5  0  2  4
310  190  250  10  10  5  5  2  4
310  170  250  10  10  5  5  2  4
310  150  250  10  10  5  5  2  4
270  190  200  10  5  5  5  2  4
270  170  200  10  5  5  5  2  4
270  150  200  10  5  5  5  2  4
230  190  200  10  5  5  0  2  4
230  170  200  10  5  5  0  2  4
230  150  200  10  5  5  0  2  4