11 17
 3  3  3  3  3  3  3  3  3  3  3  3  3  3  3  3  3
 3  0  0  2  0  2  0  2  0  2  0  2  0  2  0  0  5
 3  0  0  4  4  4  4  4  4  4  4  4  4  4  0  0  5
 3  0  0  4  0  0  0  0  0  0  0  0  0  4  0  0  5
 5  0  0  4  0  2  2  2  2  2  2  2  0  4  0  0  3
 5  0  0  2  0  2  4  2  4  2  4  2  0  2  0  0  3
 5  0  0  4  0  2  2  2  2  2  2  2  0  4  0  0  3
 3  0  0  4  0  0  0  0  0  0  0  0  0  4  0  0  5
 3  0  0  4  4  4  4  4  4  4  4  4  4  4  0  0  5
 3  0  0  2  0  2  0  2  0  2  0  2  0  2  0  0  5
 3  3  3  3  3  3  3  3  3  3  3  3  3  3  3  3  3
 8  8  8  8  8  8  8  8  8  8  8  8  8  8  8  8  8
 8  8  8  8  8  8  8  8  8  8  8  8  8  8  8  8  8
 8  8  8  8  8  8  8  8  8  8  8  8  8  8  8  8  8
 8  8  8  8  8  8  8  8  8  8  8  8  8  8  8  8  8
 8  8  8  8  8  8  8  8  8  8  8  8  8  8  8  8  8
 8  8  8  8  8  8  8  8  8  8  8  8  8  8  8  8  8
 8  8  8  8  8  8  8  8  8  8  8  8  8  8  8  8  8
 8  8  8  8  8  8  8  8  8  8  8  8  8  8  8  8  8
 8  8  8  8  8  8  8  8  8  8  8  8  8  8  8  8  8
 8  8  8  8  8  8  8  8  8  8  8  8  8  8  8  8  8
 8  8  8  8  8  8  8  8  8  8  8  8  8  8  8  8  8
 3  4  3  4  3  4  3  4  3  4  3  4  3  4  3  4  3
 4  0  0 10  0 10  0 10  0 10  0 10  0 10  0  0  37
 3  0  0 13 13 13 13 13 13 13 13 13 13 13  0  0  37
 4  0  0 12  0  0  0  0  0  0  0  0  0 12  0  0  37
15  0  0 12  0  9  9  9  9  9  9  9  0 12  0  0  3
15  0  0  9  0  9 22  9 22  9 22  9  0  9  0  0  4
15  0  0 12  0  9  9  9  9  9  9  9  0 12  0  0  3
 4  0  0 12  0  0  0  0  0  0  0  0  0 12  0  0  1
 3  0  0 13 13 13 13 13 13 13 13 13 13 13  0  0  1
 4  0  0 10  0 10  0 10  0 10  0 10  0 10  0  0  1
 3  4  3  4  3  4  3  4  3  4  3  4  3  4  3  4  3
3
4 170 10
10 10 70
1 10 170
25
110 70 250 10 10 5 5 3 4
150 70 250 10 10 5 5 3 4
190 70 250 10 10 5 5 3 4
230 70 250 10 10 5 5 3 4
110 150 250 10 10 5 5 3 4
150 150 250 10 10 5 5 3 4
190 150 250 10 10 5 5 3 4
230 150 250 10 10 5 5 3 4
90 30 250 10 15 5 5 3 4
130 30 250 10 15 5 5 3 4
170 30 250 10 15 5 5 3 4
210 30 250 10 15 5 5 3 4
250 30 250 10 15 5 5 3 4
90 190 250 10 15 5 5 3 4
130 190 250 10 15 5 5 3 4
170 190 250 10 15 5 5 3 4
210 190 250 10 15 5 5 3 4
250 190 250 10 15 5 5 3 4
290 30 250 10 15 5 10 3 4
290 50 250 10 15 5 10 3 4
290 70 250 10 15 5 10 3 4
290 90 250 10 15 5 10 3 4
290 110 250 10 15 5 10 3 4
290 130 250 10 15 5 10 3 4
290 150 250 10 15 5 10 3 4
290 170 250 10 15 5 10 3 4
290 190 250 10 15 5 10 3 4