11 17
 4  4  4  4  4  4  4  4  4  4  4  4  4  4  4  4  4
 4  0  2  0  2  0  2  0  2  0  2  0  2  0  2  0  4
 4  0  0  0  0  0  0  0  0  0  0  0  0  0  0  0  4
 4  4  2  4  2  4  2  4  2  4  2  4  2  4  2  4  4
 5  0  4  2  0  2  0  2  0  2  0  2  0  2  4  0  5
 5  0  2  0  0  0  0  0  0  0  0  0  0  0  2  0  5
 5  0  4  2  0  2  0  2  0  2  0  2  0  2  4  0  5
 4  4  2  4  2  4  2  4  2  4  2  4  2  4  2  4  4
 4  0  0  0  0  0  0  0  0  0  0  0  0  0  0  0  4
 4  0  2  0  2  0  2  0  2  0  2  0  2  0  2  0  4
 4  4  4  4  4  4  4  5  5  5  4  4  4  4  4  4  4
11 11 11 11 11 11 11 11 11 11 11 11 11 11 11 11 11
11 11 11 11 11 11 11 11 11 11 11 11 11 11 11 11 11
11 11 11 11 11 11 11 11 11 11 11 11 11 11 11 11 11
11 11 11 11 11 11 11 11 11 11 11 11 11 11 11 11 11
11 11 11 11 11 11 11 11 11 11 11 11 11 11 11 11 11
11 11 11 11 11 11 11 11 11 11 11 11 11 11 11 11 11
11 11 11 11 11 11 11 11 11 11 11 11 11 11 11 11 11
11 11 11 11 11 11 11 11 11 11 11 11 11 11 11 11 11
11 11 11 11 11 11 11 11 11 11 11 11 11 11 11 11 11
11 11 11 11 11 11 11 11 11 11 11 11 11 11 11 11 11
11 11 11 11 11 11 11 11 11 11 11 11 11 11 11 11 11
26 26 26 26 26 26 26 26 26 26 26 26 26 26 26 26 26
26  0 18  0 18  0 18  0 18  0 18  0 18  0 18  0 26
26  0  0  0  0  0  0  0  0  0  0  0  0  0  0  0 26
26  4 18  4 18  4 18  4 18  4 18  4 18  4 18  4 26
 7  0  4 18  0 18  0 18  0 18  0 18  0 18  4  0 13
 7  0 18  0  0  0  0  0  0  0  0  0  0  0 18  0 13
 7  0  4 18  0 18  0 18  0 18  0 18  0 18  4  0 13
26  4 18  4 18  4 18  4 18  4 18  4 18  4 18  4 26
26  0  0  0  0  0  0  0  0  0  0  0  0  0  0  0 26
26  0 18  0 18  0 18  0 18  0 18  0 18  0 18  0 26
26 26 26 26 26 26 26 32 32 32 26 26 26 26 26 26 26
3
2 330 110
4 170 210
8 210 10
16
30 30 200 10 5 5 0 14 4
70 30 150 10 5 5 0 8 4
110 30 200 10 5 5 0 14 4
150 30 150 10 5 5 0 8 4
190 30 150 10 5 5 0 8 4
230 30 200 10 5 5 0 14 4
270 30 150 10 5 5 0 8 4
310 30 200 10 5 5 0 14 4
30 190 200 10 5 5 0 14 4
70 190 150 10 5 5 0 8 4
110 190 200 10 5 5 0 14 4
150 190 150 10 5 5 0 8 4
190 190 150 10 5 5 0 8 4
230 190 200 10 5 5 0 14 4
270 190 150 10 5 5 0 8 4
310 190 200 10 5 5 0 14 4