19 19
4 4 4 4 4 4 4 4 4 4 4 4 4 4 4 4 4 4 4 
4 0 0 0 0 0 4 0 0 0 0 0 4 0 0 0 0 0 4 
5 0 0 0 0 0 4 0 0 0 0 0 2 0 0 0 0 0 4 
5 0 0 0 0 0 4 0 0 0 0 0 2 0 0 0 0 0 4 
5 0 0 0 0 0 4 0 0 0 0 0 2 0 0 0 0 0 4 
4 0 0 0 0 0 4 0 0 0 0 0 4 0 0 0 0 0 4 
4 4 2 2 2 4 4 4 2 2 2 4 4 4 2 2 2 4 4 
4 0 0 0 0 0 4 0 0 0 0 0 4 0 0 0 0 0 4 
4 0 0 0 0 0 4 0 0 0 0 0 4 0 0 0 0 0 4 
4 0 0 0 0 0 4 0 0 0 0 0 4 0 0 0 0 0 4 
4 0 0 0 0 0 4 0 0 0 0 0 4 0 0 0 0 0 4 
4 0 0 0 0 0 4 0 0 0 0 0 4 0 0 0 0 0 4 
4 4 2 2 2 4 4 4 2 2 2 4 4 4 2 2 2 4 4 
4 0 0 0 0 0 4 0 0 0 0 0 4 0 0 0 0 0 4 
4 0 0 0 0 0 2 0 0 0 0 0 4 0 0 0 0 0 4 
4 0 0 0 0 0 2 0 0 0 0 0 4 0 0 0 0 0 4 
4 0 0 0 0 0 2 0 0 0 0 0 4 0 0 0 0 0 4 
4 0 0 0 0 0 4 0 0 0 0 0 4 0 0 0 0 0 4 
4 4 4 4 4 4 4 4 4 4 4 4 4 4 4 4 4 4 4 
8 8 8 8 8 8 8 8 8 8 8 8 8 8 8 8 8 8 8 
8 8 8 8 8 8 8 8 8 8 8 8 8 8 8 8 8 8 8 
8 8 8 8 8 8 8 8 8 8 8 8 8 8 8 8 8 8 8 
8 8 8 8 8 8 8 8 8 8 8 8 8 8 8 8 8 8 8 
8 8 8 8 8 8 8 8 8 8 8 8 8 8 8 8 8 8 8 
8 8 8 8 8 8 8 8 8 8 8 8 8 8 8 8 8 8 8 
8 8 8 8 8 8 8 8 8 8 8 8 8 8 8 8 8 8 8 
8 8 8 8 8 8 8 8 8 8 8 8 8 8 8 8 8 8 8 
8 8 8 8 8 8 8 8 8 8 8 8 8 8 8 8 8 8 8 
8 8 8 8 8 8 8 8 8 8 8 8 8 8 8 8 8 8 8 
8 8 8 8 8 8 8 8 8 8 8 8 8 8 8 8 8 8 8 
8 8 8 8 8 8 8 8 8 8 8 8 8 8 8 8 8 8 8 
8 8 8 8 8 8 8 8 8 8 8 8 8 8 8 8 8 8 8 
8 8 8 8 8 8 8 8 8 8 8 8 8 8 8 8 8 8 8 
8 8 8 8 8 8 8 8 8 8 8 8 8 8 8 8 8 8 8 
8 8 8 8 8 8 8 8 8 8 8 8 8 8 8 8 8 8 8 
8 8 8 8 8 8 8 8 8 8 8 8 8 8 8 8 8 8 8 
8 8 8 8 8 8 8 8 8 8 8 8 8 8 8 8 8 8 8 
8 8 8 8 8 8 8 8 8 8 8 8 8 8 8 8 8 8 8 
14 14 14 14 14 14 14 14 14 14 14 14 14 14 14 14 14 14 14 
14 0 0 0 0 0 12 0 0 0 0 0 12 0 0 0 0 0 14 
19 0 0 0 0 0 12 0 0 0 0 0 9 0 0 0 0 0 14 
19 0 0 0 0 0 12 0 0 0 0 0 9 0 0 0 0 0 14 
19 0 0 0 0 0 12 0 0 0 0 0 9 0 0 0 0 0 14 
14 0 0 0 0 0 12 0 0 0 0 0 12 0 0 0 0 0 14 
14 12 9 9 9 12 12 12 9 9 9 12 12 12 9 9 9 12 14 
14 0 0 0 0 0 12 0 0 0 0 0 12 0 0 0 0 0 14 
14 0 0 0 0 0 12 0 0 0 0 0 12 0 0 0 0 0 14 
14 0 0 0 0 0 12 0 0 0 0 0 12 0 0 0 0 0 14 
14 0 0 0 0 0 12 0 0 0 0 0 12 0 0 0 0 0 14 
14 0 0 0 0 0 12 0 0 0 0 0 12 0 0 0 0 0 14 
14 12 9 9 9 12 12 12 9 9 9 12 12 12 9 9 9 12 14 
14 0 0 0 0 0 12 0 0 0 0 0 12 0 0 0 0 0 14 
14 0 0 0 0 0 9 0 0 0 0 0 12 0 0 0 0 0 14 
14 0 0 0 0 0 9 0 0 0 0 0 12 0 0 0 0 0 14 
14 0 0 0 0 0 9 0 0 0 0 0 12 0 0 0 0 0 14 
14 0 0 0 0 0 12 0 0 0 0 0 12 0 0 0 0 0 14 
14 14 14 14 14 14 14 14 14 14 14 14 14 14 14 14 14 14 14 
1
5 330 50
81
30 30 350 20 20 20 10 3 5
110 30 350 20 20 20 10 3 5
70 30 350 20 20 20 10 3 5
70 70 350 20 20 20 10 3 5
30 70 350 20 20 20 10 3 5
30 110 350 20 20 20 10 3 5
70 110 350 20 20 20 10 3 5
110 110 350 20 20 20 10 3 5
110 70 350 20 20 20 10 3 5
110 150 350 20 20 20 10 3 5
70 150 350 20 20 20 10 3 5
30 150 350 20 20 20 10 3 5
30 190 350 20 20 20 10 3 5
70 190 350 20 20 20 10 3 5
110 190 350 20 20 20 10 3 5
110 230 350 20 20 20 10 3 5
70 230 350 20 20 20 10 3 5
30 230 350 20 20 20 10 3 5
30 270 350 20 20 20 10 3 5
70 270 350 20 20 20 10 3 5
110 270 350 20 20 20 10 3 5
110 310 350 20 20 20 10 3 5
70 310 350 20 20 20 10 3 5
30 310 350 20 20 20 10 3 5
30 350 350 20 20 20 10 3 5
70 350 350 20 20 20 10 3 5
110 350 350 20 20 20 10 3 5
150 30 350 20 20 25 10 3 5
150 70 350 20 20 25 10 3 5
190 70 350 20 20 25 10 3 5
190 30 350 20 20 25 10 3 5
230 30 350 20 20 25 10 3 5
230 70 350 20 20 25 10 3 5
230 110 350 20 20 25 10 3 5
190 110 350 20 20 25 10 3 5
150 110 350 20 20 25 10 3 5
150 150 350 20 20 25 10 3 5
190 150 350 20 20 25 10 3 5
230 150 350 20 20 25 10 3 5
230 190 350 20 20 25 10 3 5
190 190 350 20 20 25 10 3 5
150 190 350 20 20 25 10 3 5
150 230 350 20 20 25 10 3 5
190 230 350 20 20 25 10 3 5
230 230 350 20 20 25 10 3 5
230 270 350 20 20 25 10 3 5
190 270 350 20 20 25 10 3 5
150 270 350 20 20 25 10 3 5
150 310 350 20 20 25 10 3 5
190 310 350 20 20 25 10 3 5
230 310 350 20 20 25 10 3 5
230 350 350 20 20 25 10 3 5
190 350 350 20 20 25 10 3 5
150 350 350 20 20 25 10 3 5
270 30 350 20 20 20 10 3 5
310 30 350 20 20 20 10 3 5
350 30 350 20 20 20 10 3 5
350 70 350 20 20 20 10 3 5
310 70 350 20 20 20 10 3 5
270 70 350 20 20 20 10 3 5
270 110 350 20 20 20 10 3 5
310 110 350 20 20 20 10 3 5
350 110 350 20 20 20 10 3 5
350 150 350 20 20 20 10 3 5
310 150 350 20 20 20 10 3 5
270 150 350 20 20 20 10 3 5
350 350 350 20 20 20 10 3 5
310 350 350 20 20 20 10 3 5
270 350 350 20 20 20 10 3 5
270 310 350 20 20 20 10 3 5
310 310 350 20 20 20 10 3 5
350 310 350 20 20 20 10 3 5
350 270 350 20 20 20 10 3 5
310 270 350 20 20 20 10 3 5
270 270 350 20 20 20 10 3 5
270 230 350 20 20 20 10 3 5
270 190 350 20 20 20 10 3 5
310 190 350 20 20 20 10 3 5
310 230 350 20 20 20 10 3 5
350 230 350 20 20 20 10 3 5
350 190 350 20 20 20 10 3 5
