17 17
4 4 4 4 4 4 4 4 4 4 4 4 4 4 4 4 4 
4 0 2 0 0 0 2 0 0 0 2 0 0 0 2 0 4 
4 0 4 4 4 4 4 4 4 4 4 4 4 4 4 0 4 
4 0 4 0 0 0 4 0 0 0 4 0 0 0 4 0 4 
5 0 4 0 0 0 4 0 0 0 4 0 0 0 4 2 4 
5 0 2 2 2 2 2 2 2 2 2 2 2 2 2 0 4 
5 0 4 0 0 0 4 0 0 0 4 0 0 0 4 0 4 
4 0 4 0 0 0 4 0 0 0 4 0 0 0 4 0 4 
4 4 4 4 4 4 4 4 4 4 4 4 4 4 4 2 4 
4 0 2 0 2 0 2 0 2 0 2 0 2 0 2 0 4 
4 0 0 0 0 0 0 0 0 0 0 0 0 0 0 0 4 
4 2 0 2 0 2 0 2 0 2 0 2 0 2 0 2 4 
4 0 0 0 0 0 0 0 0 0 0 0 0 0 0 0 4 
4 0 2 0 2 0 2 0 2 0 2 0 2 0 2 0 4 
4 0 0 0 0 0 0 0 0 0 0 0 0 0 0 0 4 
4 2 0 2 0 2 0 2 0 2 0 2 0 2 0 2 4 
4 4 4 4 4 4 4 4 4 4 4 4 4 4 4 4 4 
5 5 5 5 5 5 5 5 5 5 5 5 5 5 5 5 5 
5 5 5 5 5 5 5 5 5 5 5 5 5 5 5 5 5 
5 5 5 5 5 5 5 5 5 5 5 5 5 5 5 5 5 
5 5 5 5 5 5 5 5 5 5 5 5 5 5 5 5 5 
5 5 5 5 5 5 5 5 5 5 5 5 5 5 5 5 5 
5 5 5 5 5 5 5 5 5 5 5 5 5 5 5 5 5 
5 5 5 5 5 5 5 5 5 5 5 5 5 5 5 5 5 
5 5 5 5 5 5 5 5 5 5 5 5 5 5 5 5 5 
5 5 5 5 5 5 5 5 5 5 5 5 5 5 5 5 5 
5 5 5 5 5 5 5 5 5 5 5 5 5 5 5 5 5 
5 5 5 5 5 5 5 5 5 5 5 5 5 5 5 5 5 
5 5 5 5 5 5 5 5 5 5 5 5 5 5 5 5 5 
5 5 5 5 5 5 5 5 5 5 5 5 5 5 5 5 5 
5 5 5 5 5 5 5 5 5 5 5 5 5 5 5 5 5 
5 5 5 5 5 5 5 5 5 5 5 5 5 5 5 5 5 
5 5 5 5 5 5 5 5 5 5 5 5 5 5 5 5 5 
5 5 5 5 5 5 5 5 5 5 5 5 5 5 5 5 5 
3 3 3 3 3 3 3 3 3 3 3 3 3 3 3 3 3 
3 0 4 0 0 0 4 0 0 0 4 0 0 0 4 0 3 
3 0 3 3 3 3 3 3 3 3 3 3 3 3 3 0 3 
3 0 3 0 0 0 3 0 0 0 3 0 0 0 3 0 3 
15 0 3 0 0 0 3 0 0 0 3 0 0 0 3 4 3 
15 0 4 4 4 4 4 4 4 4 4 4 4 4 4 0 3 
15 0 3 0 0 0 3 0 0 0 3 0 0 0 3 0 3 
3 0 3 0 0 0 3 0 0 0 3 0 0 0 3 0 3 
3 3 3 3 3 3 3 3 3 3 3 3 3 3 3 4 3 
3 0 4 0 4 0 4 0 4 0 4 0 4 0 4 0 3 
3 0 0 0 0 0 0 0 0 0 0 0 0 0 0 0 3 
3 4 0 4 0 4 0 4 0 4 0 4 0 4 0 4 3 
3 0 0 0 0 0 0 0 0 0 0 0 0 0 0 0 3 
3 0 4 0 4 0 4 0 4 0 4 0 4 0 4 0 3 
3 0 0 0 0 0 0 0 0 0 0 0 0 0 0 0 3 
3 4 0 4 0 4 0 4 0 4 0 4 0 4 0 4 3 
3 3 3 3 3 3 3 3 3 3 3 3 3 3 3 3 3 
1
4 330 110
53
30 30 300 20 25 15 10 3 4
70 30 300 20 25 15 10 3 4
110 30 300 20 25 15 10 3 4
150 30 300 20 25 15 10 3 4
190 30 300 20 25 15 10 3 4
230 30 300 20 25 15 10 3 4
270 30 300 20 25 15 10 3 4
310 30 300 20 25 15 10 3 4
310 70 300 20 25 15 10 3 4
310 110 300 20 25 15 10 3 4
310 150 300 20 25 15 10 3 4
270 150 300 20 25 15 10 3 4
230 130 300 20 25 15 10 3 4
230 70 300 20 25 15 10 3 4
270 90 300 20 25 15 10 3 4
190 90 300 20 25 15 10 3 4
150 70 300 20 25 15 10 3 4
150 130 300 20 25 15 10 3 4
190 150 300 20 25 15 10 3 4
110 150 300 20 25 15 10 3 4
70 130 300 20 25 15 10 3 4
70 70 300 20 25 15 10 3 4
110 90 300 20 25 15 10 3 4
30 190 300 20 30 15 10 3 4
30 270 300 20 30 15 10 3 4
50 310 300 20 30 15 10 3 4
50 230 300 20 30 15 10 3 4
70 270 300 20 30 15 10 3 4
70 190 300 20 30 15 10 3 4
90 230 300 20 30 15 10 3 4
90 310 300 20 30 15 10 3 4
110 270 300 20 30 15 10 3 4
110 190 300 20 30 15 10 3 4
130 230 300 20 30 15 10 3 4
130 310 300 20 30 15 10 3 4
150 270 300 20 30 15 10 3 4
150 190 300 20 30 15 10 3 4
170 230 300 20 30 15 10 3 4
170 310 300 20 30 15 10 3 4
190 270 300 20 30 15 10 3 4
190 190 300 20 30 15 10 3 4
210 230 300 20 30 15 10 3 4
230 270 300 20 30 15 10 3 4
210 310 300 20 30 15 10 3 4
250 310 300 20 30 15 10 3 4
270 270 300 20 30 15 10 3 4
250 230 300 20 30 15 10 3 4
230 190 300 20 30 15 10 3 4
270 190 300 20 30 15 10 3 4
290 230 300 20 30 15 10 3 4
290 310 300 20 30 15 10 3 4
310 270 300 20 30 15 10 3 4
310 190 300 20 30 15 10 3 4
