11 17
3 3 3 3 3 3 3 5 5 5 3 3 3 3 3 3 3
3 0 0 0 2 0 4 0 0 0 4 0 2 0 0 0 3
3 0 0 0 4 0 4 0 4 0 4 0 4 0 0 0 3
3 0 0 0 4 0 4 0 4 0 4 0 4 0 0 0 3
3 0 0 0 4 0 4 0 4 0 4 0 4 0 0 0 3
3 2 2 2 4 0 4 0 4 0 4 0 4 2 2 2 3
3 0 0 0 4 0 4 0 4 0 4 0 4 0 0 0 3
3 0 0 0 4 0 0 0 4 0 0 0 4 0 0 0 3
3 0 0 0 4 4 4 4 4 4 4 4 4 0 0 0 3
3 0 0 0 2 0 0 0 0 0 0 0 2 0 0 0 3
3 3 3 3 3 3 3 3 3 3 3 3 3 3 3 3 3
7 7 7 7 7 7 7 7 7 7 7 7 7 7 7 7 7
7 7 7 7 7 7 7 7 7 7 7 7 7 7 7 7 7
7 7 9 7 7 10 7 10 7 10 7 10 7 7 9 7 7
7 7 9 7 7 7 7 7 7 7 7 7 7 7 9 7 7
7 7 7 7 7 10 7 10 7 10 7 10 7 7 7 7 7
7 7 7 7 7 7 7 7 7 7 7 7 7 7 7 7 7
7 7 7 7 7 10 7 10 7 10 7 10 7 7 7 7 7
7 7 9 7 7 7 10 7 7 7 10 7 7 7 9 7 7
7 7 9 7 7 7 7 7 7 7 7 7 7 7 9 7 7
7 7 7 7 7 7 7 7 7 7 7 7 7 7 7 7 7
7 7 7 7 7 7 7 7 7 7 7 7 7 7 7 7 7
8 8 8 8 8 8 8 6 6 6 8 8 8 8 8 8 8
8 0 0 0 11 0 20 0 0 0 20 0 11 0 0 0 8
8 0 0 0 20 0 20 0 20 0 20 0 20 0 0 0 8
8 0 0 0 20 0 20 0 20 0 20 0 20 0 0 0 8
8 0 0 0 20 0 20 0 20 0 20 0 20 0 0 0 8
8 11 11 11 20 0 20 0 20 0 20 0 20 11 11 11 8
8 0 0 0 20 0 20 0 20 0 20 0 20 0 0 0 8
8 0 0 0 20 0 0 0 20 0 0 0 20 0 0 0 8
8 0 0 0 20 20 20 20 20 20 20 20 20 0 0 0 8
8 0 0 0 11 0 0 0 0 0 0 0 11 0 0 0 8
8 8 8 8 8 8 8 8 8 8 8 8 8 8 8 8 8
1
2 170 210
40
110 30 200 25 15 10 10 4 3
110 50 200 25 15 10 10 4 3
110 70 200 25 15 10 10 4 3
110 90 200 25 15 10 10 4 3
110 110 200 25 15 10 10 4 3
110 130 200 25 15 10 10 4 3
230 130 200 25 15 10 10 4 3
230 110 200 25 15 10 10 4 3
230 90 200 25 15 10 10 4 3
230 70 200 25 15 10 10 4 3
230 50 200 25 15 10 10 4 3
230 30 200 25 15 10 10 4 3
230 190 200 25 15 10 10 4 3
210 190 200 25 15 10 10 4 3
130 190 200 25 15 10 10 4 3
110 190 200 25 15 10 10 4 3
70 50 200 30 15 10 10 4 3
50 50 200 30 15 10 10 4 3
30 50 200 30 15 10 10 4 3
30 70 200 30 15 10 10 4 3
50 70 200 30 15 10 10 4 3
70 70 200 30 15 10 10 4 3
70 150 200 30 15 10 10 4 3
50 150 200 30 15 10 10 4 3
30 150 200 30 15 10 10 4 3
30 170 200 30 15 10 10 4 3
50 170 200 30 15 10 10 4 3
70 170 200 30 15 10 10 4 3
310 170 200 30 15 10 10 4 3
290 170 200 30 15 10 10 4 3
270 170 200 30 15 10 10 4 3
270 150 200 30 15 10 10 4 3
290 150 200 30 15 10 10 4 3
310 150 200 30 15 10 10 4 3
310 70 200 30 15 10 10 4 3
290 70 200 30 15 10 10 4 3
270 70 200 30 15 10 10 4 3
270 50 200 30 15 10 10 4 3
290 50 200 30 15 10 10 4 3
310 50 200 30 15 10 10 4 3