11  17
 3  3  3  3  3  3  3  3  3  3  3  3  3  3  3  3  3
 3  0  0  2  0  0  2  0  0  0  2  0  0  2  0  0  5
 3  0  2  0  0  2  0  0  2  0  0  2  0  0  2  0  5
 3  2  0  0  2  0  0  2  0  2  0  0  2  0  0  2  5
 3  0  0  2  0  0  2  0  0  0  2  0  0  2  0  0  3
 3  0  2  0  0  2  0  0  4  0  0  2  0  0  2  0  3
 3  0  0  2  0  0  2  0  0  0  2  0  0  2  0  0  3
 5  2  0  0  2  0  0  2  0  2  0  0  2  0  0  2  5
 5  0  2  0  0  2  0  0  2  0  0  2  0  0  2  0  5
 5  0  0  2  0  0  2  0  0  0  2  0  0  2  0  0  5
 3  3  3  3  3  3  3  3  3  3  3  3  3  3  3  3  3
 6  6  6  6  6  6  6  6  6  6  6  6  6  6  6  6  6
 6  6  6  6  6  6  6  6  6  6  6  6  6  6  6  6  6
 6  6  6  6  6  6  6  6  6  6  6  6  6  6  6  6  6
 6  6  6  6  6  6  6  6  6  6  6  6  6  6  6  6  6
 6  6  6  6  6  6  6  6  6  6  6  6  6  6  6  6  6
 6  6  6  6  6  6  6  6  6  6  6  6  6  6  6  6  6
 6  6  6  6  6  6  6  6  6  6  6  6  6  6  6  6  6
 6  6  6  6  6  6  6  6  6  6  6  6  6  6  6  6  6
 6  6  6  6  6  6  6  6  6  6  6  6  6  6  6  6  6
 6  6  6  6  6  6  6  6  6  6  6  6  6  6  6  6  6
 6  6  6  6  6  6  6  6  6  6  6  6  6  6  6  6  6
 5  5  5  5  5  5  5  5  5  5  5  5  5  5  5  5  5
 5  0  0  6  0  0  7  0  0  0  7  0  0  6  0  0  5
 5  0  6  0  0  7  0  0  8  0  0  7  0  0  6  0  5
 5  6  0  0  7  0  0  8  0  8  0  0  7  0  0  6  5
 5  0  0  7  0  0  8  0  0  0  8  0  0  7  0  0  5
 5  0  7  0  0  8  0  0  1  0  0  8  0  0  7  0  5
 5  0  0  7  0  0  8  0  0  0  8  0  0  7  0  0  5
19  6  0  0  7  0  0  8  0  8  0  0  7  0  0  6 21
19  0  6  0  0  7  0  0  8  0  0  7  0  0  6  0 21
19  0  0  6  0  0  7  0  0  0  7  0  0  6  0  0 21
 5  5  5  5  5  5  5  5  5  5  5  5  5  5  5  5  5
3
2 10  110
5 330 170
6 10 90
12
110  30  100  5  5  0  0  0  1
230  30  100  5  5  0  0  0  1
110  190  100  5  5  0  0  0  1
230  190  100  5  5  0  0  0  1
170  30  100  10  5  5  0  0  1
70  110  100  10  5  5  0  0  1
170  190  100  10  5  5  0  0  1
270  110  100  10  5  5  0  0  1
170  70  150  10  5  5  0  0  1
130  110  150  10  5  5  0  0  1
210  110  150  10  5  5  0  0  1
170  150  150  10  5  5  0  0  1