21 21
4 4 4 4 4 4 4 4 4 5 5 5 4 4 4 4 4 4 4 4 4 
4 0 0 0 2 0 0 0 2 0 0 0 2 0 0 0 2 0 0 0 4 
4 0 0 0 2 0 0 0 2 0 0 0 2 0 0 0 2 0 0 0 4 
4 0 0 0 2 0 0 0 2 0 0 0 2 0 0 0 2 0 0 0 4 
4 2 2 2 4 2 2 2 4 2 2 2 4 2 2 2 4 2 2 2 4 
4 0 0 0 2 0 0 0 2 0 0 0 2 0 0 0 2 0 0 0 4 
4 0 0 0 2 0 0 0 2 0 0 0 2 0 0 0 2 0 0 0 4 
4 0 0 0 2 0 0 0 2 0 0 0 2 0 0 0 2 0 0 0 4 
4 2 2 2 4 2 2 2 4 2 2 2 4 2 2 2 4 2 2 2 4 
4 0 0 0 2 0 0 0 2 0 0 0 2 0 0 0 2 0 0 0 4 
4 0 0 0 2 0 0 0 2 0 0 0 2 0 0 0 2 0 0 0 4 
4 0 0 0 2 0 0 0 2 0 0 0 2 0 0 0 2 0 0 0 4 
4 2 2 2 4 2 2 2 4 2 2 2 4 2 2 2 4 2 2 2 4 
4 0 0 0 2 0 0 0 2 0 0 0 2 0 0 0 2 0 0 0 4 
4 0 0 0 2 0 0 0 2 0 0 0 2 0 0 0 2 0 0 0 4 
4 0 0 0 2 0 0 0 2 0 0 0 2 0 0 0 2 0 0 0 4 
4 2 2 2 2 2 2 2 2 2 2 2 2 2 2 2 2 2 2 2 4 
4 0 0 0 2 0 0 0 2 0 0 0 2 0 0 0 2 0 0 0 4 
4 0 0 0 2 0 0 0 2 0 0 0 2 0 0 0 2 0 0 0 4 
4 0 0 0 2 0 0 0 2 0 0 0 2 0 0 0 2 0 0 0 4 
4 4 4 4 4 4 4 4 4 4 4 4 4 4 4 4 4 4 4 4 4 
11 11 11 11 11 11 11 11 11 11 11 11 11 11 11 11 11 11 11 11 11 
11 11 11 11 11 11 11 11 11 11 11 11 11 11 11 11 11 11 11 11 11 
11 11 11 11 11 11 11 11 11 11 11 11 11 11 11 11 11 11 11 11 11 
11 11 11 11 11 11 11 11 11 11 11 11 11 11 11 11 11 11 11 11 11 
11 11 11 11 11 11 11 11 11 11 11 11 11 11 11 11 11 11 11 11 11 
11 11 11 11 11 11 11 11 11 11 11 11 11 11 11 11 11 11 11 11 11 
11 11 11 11 11 11 11 11 11 11 11 11 11 11 11 11 11 11 11 11 11 
11 11 11 11 11 11 11 11 11 11 11 11 11 11 11 11 11 11 11 11 11 
11 11 11 11 11 11 11 11 11 11 11 11 11 11 11 11 11 11 11 11 11 
11 11 11 11 11 11 11 11 11 11 11 11 11 11 11 11 11 11 11 11 11 
11 11 11 11 11 11 11 11 11 11 11 11 11 11 11 11 11 11 11 11 11 
11 11 11 11 11 11 11 11 11 11 11 11 11 11 11 11 11 11 11 11 11 
11 11 11 11 11 11 11 11 11 11 11 11 11 11 11 11 11 11 11 11 11 
11 11 11 11 11 11 11 11 11 11 11 11 11 11 11 11 11 11 11 11 11 
11 11 11 11 11 11 11 11 11 11 11 11 11 11 11 11 11 11 11 11 11 
11 11 11 11 11 11 11 11 11 11 11 11 11 11 11 11 11 11 11 11 11 
11 11 11 11 11 11 11 11 11 11 11 11 11 11 11 11 11 11 11 11 11 
11 11 11 11 11 11 11 11 11 11 11 11 11 11 11 11 11 11 11 11 11 
11 11 11 11 11 11 11 11 11 11 11 11 11 11 11 11 11 11 11 11 11 
11 11 11 11 11 11 11 11 11 11 11 11 11 11 11 11 11 11 11 11 11 
11 11 11 11 11 11 11 11 11 11 11 11 11 11 11 11 11 11 11 11 11 
26 26 26 26 26 26 26 26 26 10 10 10 26 26 26 26 26 26 26 26 26 
26 0 0 0 16 0 0 0 16 0 0 0 16 0 0 0 16 0 0 0 26 
26 0 0 0 16 0 0 0 16 0 0 0 16 0 0 0 16 0 0 0 26 
26 0 0 0 16 0 0 0 16 0 0 0 16 0 0 0 16 0 0 0 26 
26 16 16 16 29 16 16 16 29 16 16 16 29 16 16 16 29 16 16 16 26 
26 0 0 0 16 0 0 0 16 0 0 0 16 0 0 0 16 0 0 0 26 
26 0 0 0 16 0 0 0 16 0 0 0 16 0 0 0 16 0 0 0 26 
26 0 0 0 16 0 0 0 16 0 0 0 16 0 0 0 16 0 0 0 26 
26 16 16 16 29 16 16 16 29 16 16 16 29 16 16 16 29 16 16 16 26 
26 0 0 0 16 0 0 0 16 0 0 0 16 0 0 0 16 0 0 0 26 
26 0 0 0 16 0 0 0 16 0 0 0 16 0 0 0 16 0 0 0 26 
26 0 0 0 16 0 0 0 16 0 0 0 16 0 0 0 16 0 0 0 26 
26 16 16 16 29 16 16 16 29 16 16 16 29 16 16 16 29 16 16 16 26 
26 0 0 0 16 0 0 0 16 0 0 0 16 0 0 0 16 0 0 0 26 
26 0 0 0 16 0 0 0 16 0 0 0 16 0 0 0 16 0 0 0 26 
26 0 0 0 16 0 0 0 16 0 0 0 16 0 0 0 16 0 0 0 26 
26 16 16 16 16 16 16 16 16 16 16 16 16 16 16 16 16 16 16 16 26 
26 0 0 0 16 0 0 0 16 0 0 0 16 0 0 0 16 0 0 0 26 
26 0 0 0 16 0 0 0 16 0 0 0 16 0 0 0 16 0 0 0 26 
26 0 0 0 16 0 0 0 16 0 0 0 16 0 0 0 16 0 0 0 26 
26 26 26 26 26 26 26 26 26 26 26 26 26 26 26 26 26 26 26 26 26 
1
3 170 210
125
30 30 300 20 15 20 10 5 7
70 30 300 20 15 20 10 5 7
30 70 300 20 15 20 10 5 7
70 70 300 20 15 20 10 5 7
110 110 300 20 15 20 10 5 7
150 110 300 20 15 20 10 5 7
110 150 300 20 15 20 10 5 7
150 150 300 20 15 20 10 5 7
30 190 300 20 15 20 10 5 7
70 190 300 20 15 20 10 5 7
30 230 300 20 15 20 10 5 7
70 230 300 20 15 20 10 5 7
110 270 300 20 15 20 10 5 7
150 270 300 20 15 20 10 5 7
110 310 300 20 15 20 10 5 7
150 310 300 20 15 20 10 5 7
30 350 300 20 15 20 10 5 7
70 350 300 20 15 20 10 5 7
30 390 300 20 15 20 10 5 7
70 390 300 20 15 20 10 5 7
190 350 300 20 15 20 10 5 7
230 350 300 20 15 20 10 5 7
190 390 300 20 15 20 10 5 7
230 390 300 20 15 20 10 5 7
210 370 300 20 15 20 10 5 7
50 370 300 20 15 20 10 5 7
130 290 300 20 15 20 10 5 7
50 210 300 20 15 20 10 5 7
50 50 300 20 15 20 10 5 7
130 130 300 20 15 20 10 5 7
190 70 300 20 15 20 10 5 7
190 30 300 20 15 20 10 5 7
230 30 300 20 15 20 10 5 7
210 50 300 20 15 20 10 5 7
230 70 300 20 15 20 10 5 7
190 190 300 20 15 20 10 5 7
210 210 300 20 15 20 10 5 7
190 230 300 20 15 20 10 5 7
230 230 300 20 15 20 10 5 7
230 190 300 20 15 20 10 5 7
270 310 300 20 15 20 10 5 7
270 270 300 20 15 20 10 5 7
290 290 300 20 15 20 10 5 7
310 270 300 20 15 20 10 5 7
310 310 300 20 15 20 10 5 7
270 110 300 20 15 20 10 5 7
270 150 300 20 15 20 10 5 7
290 130 300 20 15 20 10 5 7
310 150 300 20 15 20 10 5 7
310 110 300 20 15 20 10 5 7
350 30 300 20 15 20 10 5 7
350 70 300 20 15 20 10 5 7
370 50 300 20 15 20 10 5 7
390 30 300 20 15 20 10 5 7
390 70 300 20 15 20 10 5 7
390 190 300 20 15 20 10 5 7
370 210 300 20 15 20 10 5 7
350 230 300 20 15 20 10 5 7
350 190 300 20 15 20 10 5 7
390 230 300 20 15 20 10 5 7
390 350 300 20 15 20 10 5 7
370 370 300 20 15 20 10 5 7
350 390 300 20 15 20 10 5 7
350 350 300 20 15 20 10 5 7
390 390 300 20 15 20 10 5 7
110 30 300 20 15 25 10 5 7
110 70 300 20 15 25 10 5 7
130 50 300 20 15 25 10 5 7
150 70 300 20 15 25 10 5 7
150 30 300 20 15 25 10 5 7
70 110 300 20 15 25 10 5 7
50 130 300 20 15 25 10 5 7
30 150 300 20 15 25 10 5 7
70 150 300 20 15 25 10 5 7
30 110 300 20 15 25 10 5 7
110 190 300 20 15 25 10 5 7
130 210 300 20 15 25 10 5 7
110 230 300 20 15 25 10 5 7
150 230 300 20 15 25 10 5 7
150 190 300 20 15 25 10 5 7
70 270 300 20 15 25 10 5 7
50 290 300 20 15 25 10 5 7
70 310 300 20 15 25 10 5 7
30 310 300 20 15 25 10 5 7
30 270 300 20 15 25 10 5 7
110 350 300 20 15 25 10 5 7
130 370 300 20 15 25 10 5 7
150 390 300 20 15 25 10 5 7
110 390 300 20 15 25 10 5 7
150 350 300 20 15 25 10 5 7
190 310 300 20 15 25 10 5 7
210 290 300 20 15 25 10 5 7
190 270 300 20 15 25 10 5 7
230 270 300 20 15 25 10 5 7
230 310 300 20 15 25 10 5 7
270 350 300 20 15 25 10 5 7
270 390 300 20 15 25 10 5 7
290 370 300 20 15 25 10 5 7
310 390 300 20 15 25 10 5 7
310 350 300 20 15 25 10 5 7
350 310 300 20 15 25 10 5 7
370 290 300 20 15 25 10 5 7
390 310 300 20 15 25 10 5 7
390 270 300 20 15 25 10 5 7
350 270 300 20 15 25 10 5 7
310 230 300 20 15 25 10 5 7
270 230 300 20 15 25 10 5 7
290 210 300 20 15 25 10 5 7
270 190 300 20 15 25 10 5 7
310 190 300 20 15 25 10 5 7
350 150 300 20 15 25 10 5 7
370 130 300 20 15 25 10 5 7
390 150 300 20 15 25 10 5 7
390 110 300 20 15 25 10 5 7
350 110 300 20 15 25 10 5 7
310 70 300 20 15 25 10 5 7
270 70 300 20 15 25 10 5 7
290 50 300 20 15 25 10 5 7
270 30 300 20 15 25 10 5 7
310 30 300 20 15 25 10 5 7
230 110 300 20 15 25 10 5 7
190 150 300 20 15 25 10 5 7
210 130 300 20 15 25 10 5 7
230 150 300 20 15 25 10 5 7
190 110 300 20 15 25 10 5 7
