20 20
4 4 4 4 4 4 4 4 4 4 4 4 4 4 4 4 4 4 4 4 
5 0 0 4 0 0 0 4 0 0 0 4 0 0 0 4 0 0 0 4 
5 4 0 4 0 4 0 4 0 4 0 4 0 4 0 4 0 4 0 4 
5 4 0 0 0 4 0 0 0 4 0 0 0 4 0 0 0 4 0 4 
4 4 4 4 4 4 4 4 4 4 4 4 4 4 4 4 4 4 2 4 
4 0 0 0 0 0 0 0 4 0 0 0 2 0 0 0 4 0 0 4 
4 0 0 0 4 0 0 4 0 0 0 2 0 0 0 4 0 0 2 4 
4 0 0 4 0 0 4 0 0 0 2 0 0 0 4 0 0 2 0 4 
4 2 4 0 0 4 0 0 0 4 0 0 0 4 0 0 2 0 0 4 
4 2 4 0 0 0 0 0 4 0 0 0 4 0 0 2 0 0 2 4 
4 0 0 4 0 0 0 4 0 0 0 4 0 0 2 0 0 2 0 4 
4 0 0 0 4 0 4 0 0 0 4 0 4 0 0 2 0 0 2 4 
4 4 4 0 0 4 0 0 0 4 0 0 0 4 0 0 2 0 0 4 
4 0 0 0 4 0 0 0 4 0 2 4 2 0 4 0 0 2 0 4 
4 0 0 4 0 0 0 4 0 2 0 4 0 2 0 4 0 0 2 4 
4 2 4 0 0 0 4 0 2 0 0 4 0 0 2 0 4 0 0 4 
4 0 4 0 0 4 0 2 0 0 0 4 0 0 0 2 0 4 2 4 
4 0 4 2 4 0 2 4 4 4 4 4 4 4 4 4 2 4 2 4 
4 0 4 0 0 2 0 0 0 0 0 4 0 0 0 0 0 0 0 4 
4 4 4 4 4 4 4 4 4 4 4 4 4 4 4 4 4 4 4 4 
6 6 6 6 6 6 6 6 6 6 6 6 6 6 6 6 6 6 6 6 
6 6 6 6 6 6 6 6 6 6 6 6 6 6 6 6 6 6 6 6 
6 6 6 6 6 6 6 6 6 6 6 6 6 6 6 6 6 6 6 6 
6 6 6 6 6 6 6 6 6 6 6 6 6 6 6 6 6 6 6 6 
6 6 6 6 6 6 6 6 6 6 6 6 6 6 6 6 6 6 6 6 
6 6 6 6 6 6 6 6 6 6 6 6 6 6 6 6 6 6 6 6 
6 6 6 6 6 6 6 6 6 6 6 6 6 6 6 6 6 6 6 6 
6 6 6 6 6 6 6 6 6 6 6 6 6 6 6 6 6 6 6 6 
6 6 6 6 6 6 6 6 6 6 6 6 6 6 6 6 6 6 6 6 
6 6 6 6 6 6 6 6 6 6 6 6 6 6 6 6 6 6 6 6 
6 6 6 6 6 6 6 6 6 6 6 6 6 6 6 6 6 6 6 6 
6 6 6 6 6 6 6 6 6 6 6 6 6 6 6 6 6 6 6 6 
6 6 6 6 6 6 6 6 6 6 6 6 6 6 6 6 6 6 6 6 
6 6 6 6 6 6 6 6 6 6 6 6 6 6 6 6 6 6 6 6 
6 6 6 6 6 6 6 6 6 6 6 6 6 6 6 6 6 6 6 6 
6 6 6 6 6 6 6 6 6 6 6 6 6 6 6 6 6 6 6 6 
6 6 6 6 6 6 6 6 6 6 6 6 6 6 6 6 6 6 6 6 
6 6 6 6 6 6 6 6 6 6 6 6 6 6 6 6 6 6 6 6 
6 6 6 6 6 6 6 6 6 6 6 6 6 6 6 6 6 6 6 6 
6 6 6 6 6 6 6 6 6 6 6 6 6 6 6 6 6 6 6 6 
16 16 16 16 16 16 16 16 16 16 16 16 16 16 16 16 16 16 16 16 
23 0 0 16 0 0 0 16 0 0 0 16 0 0 0 16 0 0 0 16 
23 16 0 16 0 16 0 16 0 16 0 16 0 16 0 16 0 16 0 16 
23 16 0 0 0 16 0 0 0 16 0 0 0 16 0 0 0 16 0 16 
16 16 16 16 16 16 16 16 16 16 16 16 16 16 16 16 16 16 7 16 
16 0 0 0 0 0 0 0 16 0 0 0 7 0 0 0 16 0 0 16 
16 0 0 0 16 0 0 16 0 0 0 7 0 0 0 16 0 0 7 16 
16 0 0 16 0 0 16 0 0 0 7 0 0 0 16 0 0 7 0 16 
16 7 16 0 0 16 0 0 0 16 0 0 0 16 0 0 7 0 0 16 
16 7 16 0 0 0 0 0 16 0 0 0 16 0 0 7 0 0 7 16 
16 0 0 16 0 0 0 16 0 0 0 16 0 0 7 0 0 7 0 16 
16 0 0 0 16 0 16 0 0 0 16 0 16 0 0 7 0 0 7 16 
16 16 16 0 0 16 0 0 0 16 0 0 0 16 0 0 7 0 0 16 
16 0 0 0 16 0 0 0 16 0 7 16 7 0 16 0 0 7 0 16 
16 0 0 16 0 0 0 16 0 7 0 16 0 7 0 16 0 0 7 16 
16 7 16 0 0 0 16 0 7 0 0 16 0 0 7 0 16 0 0 16 
16 0 16 0 0 16 0 7 0 0 0 16 0 0 0 7 0 16 7 16 
16 0 16 7 16 0 7 16 16 16 16 16 16 16 16 16 7 16 7 16 
16 0 16 0 0 7 0 0 0 0 0 16 0 0 0 0 0 0 0 16 
16 16 16 16 16 16 16 16 16 16 16 16 16 16 16 16 16 16 16 16 
1
6 490 90
62
370 70 550 25 25 20 20 5 6
370 50 550 25 25 20 20 5 6
370 30 550 25 25 20 20 5 6
350 30 550 25 25 20 20 5 6
330 30 550 25 25 20 20 5 6
330 50 550 25 25 20 20 5 6
330 70 550 25 25 20 20 5 6
310 70 550 25 25 20 20 5 6
290 70 550 25 25 20 20 5 6
290 50 550 25 25 20 20 5 6
290 30 550 25 25 20 20 5 6
270 30 550 25 25 20 20 5 6
250 30 550 25 25 20 20 5 6
250 50 550 25 25 20 20 5 6
250 70 550 25 25 20 20 5 6
370 110 550 25 25 20 20 5 6
250 210 550 25 25 20 20 5 6
370 310 550 25 25 20 20 5 6
370 210 550 25 25 20 20 5 6
310 210 550 25 25 20 20 5 6
370 270 550 25 25 20 20 5 6
370 150 550 25 25 20 20 5 6
370 370 550 25 25 20 20 5 6
250 370 550 25 25 20 20 5 6
250 330 550 25 25 20 20 5 6
290 330 550 25 25 20 20 5 6
250 290 550 25 25 20 20 5 6
210 290 550 25 25 20 20 5 6
210 330 550 25 25 20 20 5 6
170 330 550 25 25 20 20 5 6
130 370 550 25 25 20 20 5 6
210 370 550 25 25 20 20 5 6
70 330 600 25 25 20 20 5 6
70 310 600 25 25 20 20 5 6
110 290 600 25 25 20 20 5 6
110 270 600 25 25 20 20 5 6
150 250 600 25 25 20 20 5 6
150 230 600 25 25 20 20 5 6
190 210 600 25 25 20 20 5 6
190 190 600 25 25 20 20 5 6
230 170 600 25 25 20 20 5 6
230 150 600 25 25 20 20 5 6
270 130 600 25 25 20 20 5 6
270 110 600 25 25 20 20 5 6
210 110 600 25 25 20 20 5 6
190 110 600 25 25 20 20 5 6
170 150 600 25 25 20 20 5 6
150 150 600 25 25 20 20 5 6
130 190 600 25 25 20 20 5 6
110 230 600 25 25 20 20 5 6
90 190 600 25 25 20 20 5 6
90 150 600 25 25 20 20 5 6
110 150 600 25 25 20 20 5 6
110 110 600 25 25 20 20 5 6
130 110 600 25 25 20 20 5 6
30 110 600 25 25 20 20 5 6
50 130 600 25 25 20 20 5 6
30 210 600 25 25 20 20 5 6
50 230 600 25 25 20 20 5 6
70 250 600 25 25 20 20 5 6
50 270 600 25 25 20 20 5 6
30 290 600 25 25 20 20 5 6
