10 25
 4 4 4 4 4 4 4 4 4 4 4 4 4 4 4 4 4 4 4 4 4 4 4 4 4
 4 0 3 0 0 3 0 0 3 0 0 2 0 0 2 0 0 3 0 0 3 0 0 3 4
 4 0 3 0 0 3 0 0 2 0 0 3 0 0 3 0 0 2 0 0 3 0 0 3 4
 5 0 3 0 0 2 0 0 3 0 0 3 0 0 3 0 0 3 0 0 2 0 0 3 5
 5 0 2 0 0 3 0 0 3 0 0 3 0 0 3 0 0 3 0 0 3 0 0 0 5
 5 0 2 0 0 3 0 0 3 0 0 3 0 0 3 0 0 3 0 0 3 0 0 0 5
 4 0 3 0 0 2 0 0 3 0 0 3 0 0 3 0 0 3 0 0 2 0 0 3 4
 4 0 3 0 0 3 0 0 2 0 0 3 0 0 3 0 0 2 0 0 3 0 0 3 4
 4 0 3 0 0 3 0 0 3 0 0 2 0 0 2 0 0 3 0 0 3 0 0 3 4
 4 4 4 4 4 4 4 4 4 4 4 4 4 4 4 4 4 4 4 4 4 4 4 4 4
 6 6 6 6 6 6 6 6 6 6 6 6 6 6 6 6 6 6 6 6 6 6 6 6 6
 6 6 6 6 6 6 6 6 6 6 6 6 6 6 6 6 6 6 6 6 6 6 6 6 6
 6 6 6 6 6 6 6 6 6 6 6 6 6 6 6 6 6 6 6 6 6 6 6 6 6
 6 6 6 6 6 6 6 6 6 6 6 6 6 6 6 6 6 6 6 6 6 6 6 6 6
 6 6 6 6 6 6 6 6 6 6 6 6 6 6 6 6 6 6 6 6 6 6 6 6 6
 6 6 6 6 6 6 6 6 6 6 6 6 6 6 6 6 6 6 6 6 6 6 6 6 6
 6 6 6 6 6 6 6 6 6 6 6 6 6 6 6 6 6 6 6 6 6 6 6 6 6
 6 6 6 6 6 6 6 6 6 6 6 6 6 6 6 6 6 6 6 6 6 6 6 6 6
 6 6 6 6 6 6 6 6 6 6 6 6 6 6 6 6 6 6 6 6 6 6 6 6 6
 6 6 6 6 6 6 6 6 6 6 6 6 6 6 6 6 6 6 6 6 6 6 6 6 6
 1 1  1 1 1  1 1 1  1 1 1  1 1 1  1 1 1  1 1 1  1 1 1  1 1
 1 0 13 0 0 13 0 0 13 0 0  2 0 0  2 0 0 13 0 0 13 0 0 13 1
 1 0 13 0 0 13 0 0  2 0 0 13 0 0 13 0 0  2 0 0 13 0 0 13 1
 3 0 13 0 0  2 0 0 13 0 0 13 0 0 13 0 0 13 0 0  2 0 0 13 41
 3 0  2 0 0 13 0 0 13 0 0 13 0 0 13 0 0 13 0 0 13 0 0  0 41
 3 0  2 0 0 13 0 0 13 0 0 13 0 0 13 0 0 13 0 0 13 0 0  0 41
 1 0 13 0 0  2 0 0 13 0 0 13 0 0 13 0 0 13 0 0  2 0 0 13 1
 1 0 13 0 0 13 0 0  2 0 0 13 0 0 13 0 0  2 0 0 13 0 0 13 1
 1 0 13 0 0 13 0 0 13 0 0  2 0 0  2 0 0 13 0 0 13 0 0 13 1
 1 1  1 1 1  1 1 1  1 1 1  1 1 1  1 1 1  1 1 1  1 1 1  1 1
2
1 330 170
11 10 50
28
70 30 250 15 15 10 10 2 4
90 30 250 15 15 10 10 2 4
130 30 250 15 15 10 10 2 4
150 30 250 15 15 10 10 2 4
190 30 250 15 15 10 10 2 4
210 30 250 15 15 10 10 2 4
250 30 250 15 15 10 10 2 4
270 30 250 15 15 10 10 2 4
310 30 300 15 15 10 10 2 4
330 30 300 15 15 10 10 2 4
370 30 300 15 15 10 10 2 4
390 30 300 15 15 10 10 2 4
430 30 300 15 15 10 10 2 4
450 30 300 15 15 10 10 2 4
70 170 250 15 15 10 10 2 4
90 170 250 15 15 10 10 2 4
130 170 250 15 15 10 10 2 4
150 170 250 15 15 10 10 2 4
190 170 250 15 15 10 10 2 4
210 170 250 15 15 10 10 2 4
250 170 250 15 15 10 10 2 4
270 170 250 15 15 10 10 2 4
310 170 300 15 15 10 10 2 4
330 170 300 15 15 10 10 2 4
370 170 300 15 15 10 10 2 4
390 170 300 15 15 10 10 2 4
430 170 300 15 15 10 10 2 4
450 170 300 15 15 10 10 2 4