11 17
 3  3  3  3  3  3  3  3  3  3  3  3  3  3  3  3  3
 3  0  0  2  0  0  0  2  0  2  0  0  0  2  0  0  3
 3  0  0  3  0  3  0  3  0  3  0  3  0  3  0  0  3
 3  2  3  3  0  0  0  2  0  2  0  0  0  3  3  2  3
 5  0  1  3  2  3  2  4  0  4  2  3  2  3  1  0  5
 5  0  1  3  0  0  0  0  0  0  0  0  0  3  1  0  5
 5  0  1  3  2  3  2  4  0  4  2  3  2  3  1  0  5
 3  2  3  3  0  0  0  2  0  2  0  0  0  3  3  2  3
 3  0  0  3  0  3  0  3  0  3  0  3  0  3  0  0  3
 3  0  0  2  0  0  0  2  0  2  0  0  0  2  0  0  3
 3  3  3  3  3  3  3  5  5  5  3  3  3  3  3  3  3
10 10 10 10 10 10 10 10 10 10 10 10 10 10 10 10 10
10 10 10 10 10  9 10  9 10  9 10  9 10 10 10 10 10
10 10 10 10 10 10 10 10 10 10 10 10 10 10 10 10 10
10 10 10 10 10  9 10  9 10  9 10  9 10 10 10 10 10
10 10 10 10 10 10 10 10 10 10 10 10 10 10 10 10 10
10 10 10 10 10  9 10  9 10  9 10  9 10 10 10 10 10
10 10 10 10 10 10 10 10 10 10 10 10 10 10 10 10 10
10 10 10 10 10  9 10  9 10  9 10  9 10 10 10 10 10
10 10 10 10 10 10 10 10 10 10 10 10 10 10 10 10 10
10 10 10 10 10  9 10  9 10  9 10  9 10 10 10 10 10
10 10 10 10 10 10 10 10 10 10 10 10 10 10 10 10 10
 6  6  6  6  6  6  6  6  6  6  6  6  6  6  6  6  6
 6  0  0 11  0  0  0 13  0 14  0  0  0 15  0  0  6
 6  0  0  6  0  8  0  8  0  7  0  7  0  6  0  0  6
 6 11  6  6  0  0  0 13  0 14  0  0  0  6  6 15  6
 3  0  4  6 13  8 13 20  0 19 14  7 14  6  4  0  9
 3  0  5  6  0  0  0  0  0  0  0  0  0  6  5  0  9
 3  0  6  6 14  7 14 19  0 20 13  8 13  6  6  0  9
 6 15  6  6  0  0  0 14  0 13  0  0  0  6  6 11  6
 6  0  0  6  0  7  0  7  0  8  0  8  0  6  0  0  6
 6  0  0 15  0  0  0 14  0 13  0  0  0 11  0  0  6
 6  6  6  6  6  6  6 28 28 28  6  6  6  6  6  6  6
3
1 330 50
3 10 110
7 170 10
24
50 50 100 10 5 5 0 0 4
290 50 100 10 5 5 0 0 4
50 170 100 10 5 5 0 0 4
290 170 100 10 5 5 0 0 4
90 70 150 10 5 5 0 1 4
250 70 150 10 5 5 0 1 4
90 150 150 10 5 5 0 1 4
250 150 150 10 5 5 0 1 4
170 30 100 10 5 5 0 1 1
170 50 100 10 5 5 0 1 1
170 70 100 10 5 5 0 1 1
170 90 100 10 5 5 0 1 1
170 130 100 10 5 5 0 1 1
170 150 100 10 5 5 0 1 1
170 170 100 10 5 5 0 1 1
170 190 100 10 5 5 0 1 1
90 110 100 10 5 5 0 1 1
110 110 100 10 5 5 0 1 1
130 110 100 10 5 5 0 1 1
150 110 100 10 5 5 0 1 1
190 110 100 10 5 5 0 1 1
210 110 100 10 5 5 0 1 1
230 110 100 10 5 5 0 1 1
250 110 100 10 5 5 0 1 1